1111111111111111111
1000000000000000001
1000000001000000001
100000001C000000001
100P000001000000001
1000000000000000101
1000000000000001E01
1111111111111111111