1111111111111
1P010000000C1
100P011111001
1P0011E0000P1
1111111111111